NO textures/simonkraft/wet_sponge.xpm
SO textures/simonkraft/wet_sponge.xpm
WE textures/simonkraft/wet_sponge.xpm
EA textures/simonkraft/wet_sponge.xpm

F 164,169,20
C 153,204,255

1111111111
1000000001
1N00000001
1000000101
1000000001
1000000001
1000100001
1000000001
1000000001
1111111111
