NO ./textures/north64x64.xpm
SO ./textures/south64x64.xpm
WE ./textures/west64x64.xpm
EA ./textures/east64x64.xpm
F 0, 255, 0
C 0, 0, 255
        1111111111111111111111111
        1000000000110000000000001
        1000000000100000000000001
        1000000000000000000000001
        1001000000000000000000001
111111111001000000E00000000000001
100000000000000000000000000011111
100000000000000000000000000011111
100000000000000000000000000011111
100000000000000000000000000011111
100000000000000000000000000011111
100000000000000000000000000011111
11111111111111111111111111111
