NO ./path_to_the_north_texture.xpm
SO ./path_to_the_south_texture.xpm
WE ./path_to_the_west_texture.xpm
EA ./path_to_the_east_texture.xpm
F 220,100,0
C 225,30,0
        1111111111111111111111111
        1000000000110000000000001
        1000000000100000000000001
        1000000000000000000000001
        1001000000000000000000001
111111111001000000W00000000000001
100000000000000000000000000011111
100000000000000000000000000011111
100000000000000000000000000011111
100000000000000000000000000011111
100000000000000000000000000011111
100000000000000000000000000011111
11111111111111111111111111111
