NO ./textures/ladrillo64.xpm
SO ./textures/chiseled_tuff_top.xpm
WE ./textures/west64x64.xpm
EA ./textures/chiseled_tuff_top.xpm
F 0, 255, 0
C 0, 0, 255

1111111111111111111111111111111
10000000000000000000000001 1101
10000000000E000000000000011111
10000000000000000000000001
10000000000000000000000001
10000000000000000000000001
10000000000000000000000001
10000000000000000000000001
10000000000000000000000001
10000000000000000000000001
10000000000000000000000001
10000000000000000000000001
10000000000000000000000001
1111111111111111111111111
