NO ./textures/ladrillo64.xpm
SO ./textures/green64.xpm
WE ./textures/wood64.xpm
EA ./textures/blue64.xpm
F 141,132,131
C 135,206,235
        1111111111111111111111111
        1000000000110000000000001
        1011000001110000000000001
        1001000000000000000000001
111111111011000001110000000000001
100000000011000001111111111111111
11111111111111111000000010001
11110111111111011101010010001
11000000110101011100000010001
1000000000000000110000001000111111111111
10000000000000001101010010001
11000001110101011111011110N0111
11110111 1110101 101111010001
11111111 1111111 11111111111