NO ./textures/north64x64.xpm
SO ./textures/chiseled_tuff_top.xpm
WE ./textures/west64x64.xpm
EA ./textures/chiseled_tuff_top.xpm
F 0, 255, 0
C 0, 0, 255

11111111111111111111111111
10000000000000000000000001
10000000000E00000000000001
10000000000000000000000001
10000000000000000000000001
10000000000000000000000001
10000000000000000000000001
10000000000000000000000001
10000000000000000000000001
10000000000000000000000001
10000000000000000000000001
10000000000000000000000001
10000000000000000000000001
11111111111111111111111111
